                                                           X                                                           
                                                          ???                                                          
                                                        /     \                                                        
                                                       /       \                                                       
                                                      /         \                                                      
                                                     /           \                                                     
                                                    O-------------O                                                    
                                                   /               \                                                   
                                                  /                 \                                                  
                                                 /                   \                                                 
                                                /                     \                                                
                                               /                       \                                               
                     X ---------O-------------<[                       ]>-------------O--------- X                     
                    ???        /               \                       /               \        ???                    
                      \       /                 \                     /                 \       /                      
                       \     /                   \                   /                   \     /                       
                        \   /                     \                 /                     \   /                        
                         \ /                       \               /                       \ /                         
            >-------------O[                       ]>-------------<[                       ]O-------------<            
           /               \                       /               \                       /               \           
          /                 \                     /                 \                     /                 \          
         /                   \                   /                   \                   /                   \         
        /                     \                 /                     \                 /                     \        
       /                       \               /                       \               /                       \       
      <[                       ]>-------------<[                       ]>-------------<[                       ]>      
       \                       /               \                       /               \                       /       
        \                     /                 \                     /                 \                     /        
         \                   /                   \                   /                   \                   /         
          \                 /                     \                 /                     \                 /          
           \               /                       \               /                       \               /           
 X ---------O-------------<[                       ]>-------------<[                       ]>-------------O--------- X 
???        /               \                       /               \                       /               \        ???
  \       /                 \                     /                 \                     /                 \       /  
   \     /                   \                   /                   \                   /                   \     /   
    \   /                     \                 /                     \                 /                     \   /    
     \ /                       \               /                       \               /                       \ /     
      O[                       ]>-------------<[                       ]>-------------<[                       ]O      
       \                       /               \                       /               \                       /       
        \                     /                 \                     /                 \                     /        
         \                   /                   \                   /                   \                   /         
          \                 /                     \                 /                     \                 /          
           \               /                       \               /                       \               /           
            >-------------<[                       ]>-------------<[                       ]>-------------<            
           /               \                       /               \                       /               \           
          /                 \                     /                 \                     /                 \          
         /                   \                   /                   \                   /                   \         
        /                     \                 /                     \                 /                     \        
       /                       \               /                       \               /                       \       
      O[                       ]>-------------<[                       ]>-------------<[                       ]O      
     / \                       /               \                       /               \                       / \     
    /   \                     /                 \                     /                 \                     /   \    
   /     \                   /                   \                   /                   \                   /     \   
  /       \                 /                     \                 /                     \                 /       \  
 X         \               /                       \               /                       \               /         X 
??? --------O-------------<[                       ]>-------------<[                       ]>-------------O-------- ???
                           \                       /               \                       /                           
                            \                     /                 \                     /                            
                             \                   /                   \                   /                             
                              \                 /                     \                 /                              
                               \               /                       \               /                               
                                O-------------O[                       ]O-------------O                                
                                 \           / \                       / \           /                                 
                                  \         /   \                     /   \         /                                  
                                   \       /     \                   /     \       /                                   
                                    \     /       \                 /       \     /                                    
                                       X           \               /           X                                       
                                      ???           >-------------<           ???                                      
