                                                                                                           
                                                                                                           
                                                                                                           
                                                                                                           
                                              >-------------<                                              
                                             /               \                                             
                                            /                 \                                            
                                           /                   \                                           
                                          /                     \                                          
                                         /                       \                                         
                          >-------------<[                       ]>-------------<                          
                         /               \                       /               \                         
                        /                 \                     /                 \                        
                       /                   \                   /                   \                       
                      /                     \                 /                     \                      
                     /                       \               /                       \                     
      >-------------<[                       ]>-------------<[                       ]>-------------<      
     /               \                       /               \                       /               \     
    /                 \                     /                 \                     /                 \    
   /                   \                   /                   \                   /                   \   
  /                     \                 /                     \                 /                     \  
 /                       \               /                       \               /                       \ 
<[                       ]>-------------<[                       ]>-------------<[                       ]>
 \                       /               \                       /               \                       / 
  \                     /                 \                     /                 \                     /  
   \                   /                   \                   /                   \                   /   
    \                 /                     \                 /                     \                 /    
     \               /                       \               /                       \               /     
      >-------------<[                       ]>-------------<[                       ]>-------------<      
     /               \                       /               \                       /               \     
    /                 \                     /                 \                     /                 \    
   /                   \                   /                   \                   /                   \   
  /                     \                 /                     \                 /                     \  
 /                       \               /                       \               /                       \ 
<[                       ]>-------------<[                       ]>-------------<[                       ]>
 \                       /               \                       /               \                       / 
  \                     /                 \                     /                 \                     /  
   \                   /                   \                   /                   \                   /   
    \                 /                     \                 /                     \                 /    
     \               /                       \               /                       \               /     
      >-------------<[                       ]>-------------<[                       ]>-------------<      
     /               \                       /               \                       /               \     
    /                 \                     /                 \                     /                 \    
   /                   \                   /                   \                   /                   \   
  /                     \                 /                     \                 /                     \  
 /                       \               /                       \               /                       \ 
<[                       ]>-------------<[                       ]>-------------<[                       ]>
 \                       /               \                       /               \                       / 
  \                     /                 \                     /                 \                     /  
   \                   /                   \                   /                   \                   /   
    \                 /                     \                 /                     \                 /    
     \               /                       \               /                       \               /     
      >-------------<[                       ]>-------------<[                       ]>-------------<      
                     \                       /               \                       /                     
                      \                     /                 \                     /                      
                       \                   /                   \                   /                       
                        \                 /                     \                 /                        
                         \               /                       \               /                         
                          >-------------<[                       ]>-------------<                          
                                         \                       /                                         
                                          \                     /                                          
                                           \                   /                                           
                                            \                 /                                            
                                             \               /                                             
                                              >-------------<                                              
