                                                                                                                               
                                                                                                                               
                                                                                                                               
                                                      >-----------------<                                                      
                                                     /                   \                                                     
                                                    /                     \                                                    
                                                   /                       \                                                   
                                                  /                         \                                                  
                                                 /                           \                                                 
                              >-----------------<[                           ]>-----------------<                              
                             /                   \                           /                   \                             
                            /                     \                         /                     \                            
                           /                       \                       /                       \                           
                          /                         \                     /                         \                          
                         /                           \                   /                           \                         
      >-----------------<[                           ]>-----------------<[                           ]>-----------------<      
     /                   \                           /                   \                           /                   \     
    /                     \                         /                     \                         /                     \    
   /                       \                       /                       \                       /                       \   
  /                         \                     /                         \                     /                         \  
 /                           \                   /                           \                   /                           \ 
<[                           ]>-----------------<[                           ]>-----------------<[                           ]>
 \                           /                   \                           /                   \                           / 
  \                         /                     \                         /                     \                         /  
   \                       /                       \                       /                       \                       /   
    \                     /                         \                     /                         \                     /    
     \                   /                           \                   /                           \                   /     
      >-----------------<[                           ]>-----------------<[                           ]>-----------------<      
     /                   \                           /                   \                           /                   \     
    /                     \                         /                     \                         /                     \    
   /                       \                       /                       \                       /                       \   
  /                         \                     /                         \                     /                         \  
 /                           \                   /                           \                   /                           \ 
<[                           ]>-----------------<[                           ]>-----------------<[                           ]>
 \                           /                   \                           /                   \                           / 
  \                         /                     \                         /                     \                         /  
   \                       /                       \                       /                       \                       /   
    \                     /                         \                     /                         \                     /    
     \                   /                           \                   /                           \                   /     
      >-----------------<[                           ]>-----------------<[                           ]>-----------------<      
     /                   \                           /                   \                           /                   \     
    /                     \                         /                     \                         /                     \    
   /                       \                       /                       \                       /                       \   
  /                         \                     /                         \                     /                         \  
 /                           \                   /                           \                   /                           \ 
<[                           ]>-----------------<[                           ]>-----------------<[                           ]>
 \                           /                   \                           /                   \                           / 
  \                         /                     \                         /                     \                         /  
   \                       /                       \                       /                       \                       /   
    \                     /                         \                     /                         \                     /    
     \                   /                           \                   /                           \                   /     
      >-----------------<[                           ]>-----------------<[                           ]>-----------------<      
                         \                           /                   \                           /                         
                          \                         /                     \                         /                          
                           \                       /                       \                       /                           
                            \                     /                         \                     /                            
                             \                   /                           \                   /                             
                              >-----------------<[                           ]>-----------------<                              
                                                 \                           /                                                 
                                                  \                         /                                                  
                                                   \                       /                                                   
                                                    \                     /                                                    
                                                     \                   /                                                     
                                                      >-----------------<                                                      
