                                                                                                                               
                                                                                                                               
                                                                                                                               
                                                      >██████████████████                                                      
                                                     █                   █                                                     
                                                    █                     █                                                    
                                                   █                       █                                                   
                                                  █                         █                                                  
                                                 █                           █                                                 
                              >██████████████████[                           ]>██████████████████                              
                             █                   █                           █                   █                             
                            █                     █                         █                     █                            
                           █                       █                       █                       █                           
                          █                         █                     █                         █                          
                         █                           █                   █                           █                         
      >██████████████████[                           ]>██████████████████[                           ]>██████████████████      
     █                   █                           █                   █                           █                   █     
    █                     █                         █                     █                         █                     █    
   █                       █                       █                       █                       █                       █   
  █                         █                     █                         █                     █                         █  
 █                           █                   █                           █                   █                           █ 
█[                           ]>██████████████████[                           ]>██████████████████[                           ]>
 █                           █                   █                           █                   █                           █ 
  █                         █                     █                         █                     █                         █  
   █                       █                       █                       █                       █                       █   
    █                     █                         █                     █                         █                     █    
     █                   █                           █                   █                           █                   █     
      >██████████████████[                           ]>██████████████████[                           ]>██████████████████      
     █                   █                           █                   █                           █                   █     
    █                     █                         █                     █                         █                     █    
   █                       █                       █                       █                       █                       █   
  █                         █                     █                         █                     █                         █  
 █                           █                   █                           █                   █                           █ 
█[                           ]>██████████████████[                           ]>██████████████████[                           ]>
 █                           █                   █                           █                   █                           █ 
  █                         █                     █                         █                     █                         █  
   █                       █                       █                       █                       █                       █   
    █                     █                         █                     █                         █                     █    
     █                   █                           █                   █                           █                   █     
      >██████████████████[                           ]>██████████████████[                           ]>██████████████████      
     █                   █                           █                   █                           █                   █     
    █                     █                         █                     █                         █                     █    
   █                       █                       █                       █                       █                       █   
  █                         █                     █                         █                     █                         █  
 █                           █                   █                           █                   █                           █ 
█[                           ]>██████████████████[                           ]>██████████████████[                           ]>
 █                           █                   █                           █                   █                           █ 
  █                         █                     █                         █                     █                         █  
   █                       █                       █                       █                       █                       █   
    █                     █                         █                     █                         █                     █    
     █                   █                           █                   █                           █                   █     
      >██████████████████[                           ]>██████████████████[                           ]>██████████████████      
                         █                           █                   █                           █                         
                          █                         █                     █                         █                          
                           █                       █                       █                       █                           
                            █                     █                         █                     █                            
                             █                   █                           █                   █                             
                              >██████████████████[                           ]>██████████████████                              
                                                 █                           █                                                 
                                                  █                         █                                                  
                                                   █                       █                                                   
                                                    █                     █                                                    
                                                     █                   █                                                     
                                                      >██████████████████                                                      
